Year,Period,Branch,Branch (Name),Parts Counter,Parts Shop,Parts Other,Parts All
2019,1,113,Raleigh,1411,1010,861,3282
2019,1,114,Charlotte,2526,1663,1841,6030
2019,1,117,Greenville,366,262,273,901
2019,1,160,Asheville,1672,775,455,2902
2019,1,215,Columbia,1319,887,1244,3450
2019,1,216,Piedmont,1058,434,562,2054
2019,1,218,Charleston,941,646,745,2332
2019,1,364,Macon,79,135,76,290
2019,1,365,Savannah,1781,1161,1809,4751
2019,1,367,Buford,2148,1865,1206,5219
2019,1,520,Knoxville,591,412,233,1236
2019,1,536,Chattanooga,594,112,57,763
2019,2,113,Raleigh,933,999,1012,2944
2019,2,114,Charlotte,2948,1204,2156,6308
2019,2,117,Greenville,574,170,216,960
2019,2,160,Asheville,1250,1495,565,3310
2019,2,215,Columbia,1994,1057,1039,4090
2019,2,216,Piedmont,747,248,1780,2775
2019,2,218,Charleston,1309,450,425,2184
2019,2,364,Macon,31,163,99,293
2019,2,365,Savannah,1828,449,1507,3784
2019,2,367,Buford,1985,1666,1151,4802
2019,2,520,Knoxville,627,327,219,1173
2019,2,536,Chattanooga,452,270,74,796
2019,3,113,Raleigh,1522,1557,1277,4356
2019,3,114,Charlotte,2748,1181,2248,6177
2019,3,117,Greenville,542,136,277,955
2019,3,160,Asheville,1635,587,738,2960
2019,3,215,Columbia,1494,785,1841,4120
2019,3,216,Piedmont,1376,529,1380,3285
2019,3,218,Charleston,2066,941,1611,4618
2019,3,364,Macon,270,450,338,1058
2019,3,365,Savannah,1300,670,1478,3448
2019,3,367,Buford,2158,1292,1507,4957
2019,3,520,Knoxville,530,413,128,1071
2019,3,536,Chattanooga,792,186,221,1199
2019,4,113,Raleigh,2098,1115,608,3821
2019,4,114,Charlotte,2794,1262,2803,6859
2019,4,117,Greenville,730,246,385,1361
2019,4,160,Asheville,1781,633,720,3134
2019,4,215,Columbia,2232,1046,1616,4894
2019,4,216,Piedmont,1311,244,1268,2823
2019,4,218,Charleston,1514,514,1000,3028
2019,4,364,Macon,444,115,331,890
2019,4,365,Savannah,1863,399,2050,4312
2019,4,367,Buford,2379,1244,1735,5358
2019,4,520,Knoxville,1036,362,563,1961
2019,4,536,Chattanooga,560,558,120,1238
2019,5,113,Raleigh,2525,1858,1144,5527
2019,5,114,Charlotte,3019,1449,1939,6407
2019,5,117,Greenville,975,316,724,2015
2019,5,160,Asheville,2713,687,844,4244
2019,5,215,Columbia,1767,1253,2137,5157
2019,5,216,Piedmont,1310,564,647,2521
2019,5,218,Charleston,1336,354,1080,2770
2019,5,364,Macon,693,224,196,1113
2019,5,365,Savannah,1915,881,1040,3836
2019,5,367,Buford,2562,1210,1278,5050
2019,5,520,Knoxville,913,399,375,1687
2019,5,536,Chattanooga,924,490,122,1536
2019,6,113,Raleigh,2084,1236,503,3823
2019,6,114,Charlotte,2278,977,2561,5816
2019,6,117,Greenville,428,258,237,923
2019,6,160,Asheville,1268,490,364,2122
2019,6,215,Columbia,2193,494,1149,3836
2019,6,216,Piedmont,1203,391,1116,2710
2019,6,218,Charleston,1329,935,748,3012
2019,6,364,Macon,468,237,191,896
2019,6,365,Savannah,1190,1337,1667,4194
2019,6,367,Buford,1907,1928,1112,4947
2019,6,520,Knoxville,574,401,208,1183
2019,6,536,Chattanooga,784,404,290,1478
2019,7,113,Raleigh,2376,3018,1056,6450
2019,7,114,Charlotte,2464,787,2033,5284
2019,7,117,Greenville,549,219,245,1013
2019,7,160,Asheville,1561,771,519,2851
2019,7,215,Columbia,1809,1601,1625,5035
2019,7,216,Piedmont,895,499,912,2306
2019,7,218,Charleston,1377,424,1744,3545
2019,7,364,Macon,473,182,222,877
2019,7,365,Savannah,1520,1419,1623,4562
2019,7,367,Buford,2849,1326,1059,5234
2019,7,520,Knoxville,1376,316,170,1862
2019,7,536,Chattanooga,589,259,46,894
2019,8,113,Raleigh,2376,1514,1308,5198
2019,8,114,Charlotte,2951,1370,2562,6883
2019,8,117,Greenville,646,77,357,1080
2019,8,160,Asheville,1386,502,1727,3615
2019,8,215,Columbia,1442,609,931,2982
2019,8,216,Piedmont,1085,551,766,2402
2019,8,218,Charleston,1724,211,650,2585
2019,8,364,Macon,576,70,133,779
2019,8,365,Savannah,2409,423,1626,4458
2019,8,367,Buford,3204,1090,1110,5404
2019,8,520,Knoxville,1080,417,174,1671
2019,8,536,Chattanooga,608,235,216,1059
2019,9,113,Raleigh,1537,1245,1037,3819
2019,9,114,Charlotte,2761,1461,2199,6421
2019,9,117,Greenville,496,312,169,977
2019,9,160,Asheville,1434,746,846,3026
2019,9,215,Columbia,1918,1246,590,3754
2019,9,216,Piedmont,1068,622,900,2590
2019,9,218,Charleston,1238,639,661,2538
2019,9,364,Macon,287,73,159,519
2019,9,365,Savannah,1656,273,2063,3992
2019,9,367,Buford,2162,1992,1122,5276
2019,9,520,Knoxville,747,135,157,1039
2019,9,536,Chattanooga,586,446,48,1080
2019,10,113,Raleigh,2164,1614,912,4690
2019,10,114,Charlotte,3355,2072,1968,7395
2019,10,117,Greenville,530,251,307,1088
2019,10,160,Asheville,1697,1407,643,3747
2019,10,215,Columbia,1219,1593,1521,4333
2019,10,216,Piedmont,979,461,493,1933
2019,10,218,Charleston,1121,764,1031,2916
2019,10,364,Macon,493,253,328,1074
2019,10,365,Savannah,1553,1845,1047,4445
2019,10,367,Buford,3198,2051,1180,6429
2019,10,520,Knoxville,884,460,186,1530
2019,10,536,Chattanooga,553,269,129,951
2019,11,113,Raleigh,1480,1707,1147,4334
2019,11,114,Charlotte,2509,906,1417,4832
2019,11,117,Greenville,379,250,485,1114
2019,11,160,Asheville,863,470,894,2227
2019,11,215,Columbia,1079,742,684,2505
2019,11,216,Piedmont,578,545,691,1814
2019,11,218,Charleston,880,461,1053,2394
2019,11,364,Macon,222,246,255,723
2019,11,365,Savannah,1269,911,663,2843
2019,11,367,Buford,1251,2331,1080,4662
2019,11,520,Knoxville,652,352,154,1158
2019,11,536,Chattanooga,549,145,182,876
2019,12,113,Raleigh,1324,1200,912,3436
2019,12,114,Charlotte,1954,1270,2474,5698
2019,12,117,Greenville,966,270,313,1549
2019,12,160,Asheville,1182,648,1072,2902
2019,12,215,Columbia,1285,1013,1146,3444
2019,12,216,Piedmont,518,271,539,1328
2019,12,218,Charleston,970,382,629,1981
2019,12,364,Macon,641,155,171,967
2019,12,365,Savannah,1156,700,1115,2971
2019,12,367,Buford,1694,704,1132,3530
2019,12,520,Knoxville,748,1068,278,2094
2019,12,536,Chattanooga,526,420,118,1064
2020,1,113,Raleigh,1862,1115,1080,4057
2020,1,114,Charlotte,2486,1491,2747,6724
2020,1,117,Greenville,773,361,298,1432
2020,1,160,Asheville,1005,583,861,2449
2020,1,215,Columbia,1919,572,612,3103
2020,1,216,Piedmont,832,453,1658,2943
2020,1,218,Charleston,1121,801,498,2420
2020,1,364,Macon,549,154,227,930
2020,1,365,Savannah,1894,578,2136,4608
2020,1,367,Buford,2197,1322,917,4436
2020,1,520,Knoxville,469,159,59,687
2020,1,536,Chattanooga,605,249,255,1109
2020,2,113,Raleigh,1641,1454,1188,4283
2020,2,114,Charlotte,1857,1646,2939,6442
2020,2,117,Greenville,640,330,205,1175
2020,2,160,Asheville,1121,667,392,2180
2020,2,215,Columbia,1456,1396,605,3457
2020,2,216,Piedmont,914,430,1128,2472
2020,2,218,Charleston,1020,603,481,2104
2020,2,364,Macon,703,95,127,925
2020,2,365,Savannah,1109,647,944,2700
2020,2,367,Buford,1611,822,1334,3767
2020,2,520,Knoxville,728,322,65,1115
2020,2,536,Chattanooga,1254,143,110,1507
2020,3,113,Raleigh,2033,1260,976,4269
2020,3,114,Charlotte,2501,901,2687,6089
2020,3,117,Greenville,518,374,280,1172
2020,3,160,Asheville,1008,1354,1171,3533
2020,3,215,Columbia,1302,1777,1084,4163
2020,3,216,Piedmont,943,591,627,2161
2020,3,218,Charleston,1041,925,937,2903
2020,3,364,Macon,824,217,259,1300
2020,3,365,Savannah,1678,941,981,3600
2020,3,367,Buford,1576,2096,1561,5233
2020,3,520,Knoxville,525,444,61,1030
2020,3,536,Chattanooga,543,557,159,1259
2020,4,113,Raleigh,2253,2305,964,5522
2020,4,114,Charlotte,2201,1247,2191,5639
2020,4,117,Greenville,462,364,421,1247
2020,4,160,Asheville,1155,654,1015,2824
2020,4,215,Columbia,1456,865,751,3072
2020,4,216,Piedmont,1150,1302,453,2905
2020,4,218,Charleston,1293,956,1338,3587
2020,4,364,Macon,537,289,169,995
2020,4,365,Savannah,1673,1475,1578,4726
2020,4,367,Buford,2218,773,941,3932
2020,4,520,Knoxville,597,387,131,1115
2020,4,536,Chattanooga,491,284,17,792
2020,5,113,Raleigh,1542,996,1372,3910
2020,5,114,Charlotte,2196,1069,2000,5265
2020,5,117,Greenville,538,179,790,1507
2020,5,160,Asheville,1953,381,488,2822
2020,5,215,Columbia,1392,1242,682,3316
2020,5,216,Piedmont,767,286,458,1511
2020,5,218,Charleston,1020,623,804,2447
2020,5,364,Macon,478,166,577,1221
2020,5,365,Savannah,1232,918,1793,3943
2020,5,367,Buford,2637,1136,1111,4884
2020,5,520,Knoxville,612,336,248,1196
2020,5,536,Chattanooga,665,213,315,1193
2020,6,113,Raleigh,1751,891,1077,3719
2020,6,114,Charlotte,2923,1957,1845,6725
2020,6,117,Greenville,303,467,302,1072
2020,6,160,Asheville,1587,428,832,2847
2020,6,215,Columbia,1243,979,966,3188
2020,6,216,Piedmont,1044,612,613,2269
2020,6,218,Charleston,994,569,605,2168
2020,6,364,Macon,787,314,369,1470
2020,6,365,Savannah,1295,722,1776,3793
2020,6,367,Buford,1702,1050,703,3455
2020,6,520,Knoxville,968,442,810,2220
2020,6,536,Chattanooga,761,611,431,1803
2020,7,113,Raleigh,2410,915,1076,4401
2020,7,114,Charlotte,2643,1443,1732,5818
2020,7,117,Greenville,393,986,358,1737
2020,7,160,Asheville,1120,1144,635,2899
2020,7,215,Columbia,1580,1467,921,3968
2020,7,216,Piedmont,1065,509,2905,4479
2020,7,218,Charleston,900,1376,1477,3753
2020,7,364,Macon,480,358,219,1057
2020,7,365,Savannah,1335,528,1174,3037
2020,7,367,Buford,1853,1070,1399,4322
2020,7,520,Knoxville,822,333,210,1365
2020,7,536,Chattanooga,1619,211,38,1868
2020,8,113,Raleigh,2138,1414,1477,5029
2020,8,114,Charlotte,2400,2013,2175,6588
2020,8,117,Greenville,562,1283,617,2462
2020,8,160,Asheville,946,267,566,1779
2020,8,215,Columbia,1316,1402,630,3348
2020,8,216,Piedmont,1019,487,3000,4506
2020,8,218,Charleston,1615,1378,494,3487
2020,8,364,Macon,608,343,231,1182
2020,8,365,Savannah,1741,341,700,2782
2020,8,367,Buford,2146,630,1060,3836
2020,8,520,Knoxville,759,273,140,1172
2020,8,536,Chattanooga,618,191,265,1074
2020,9,113,Raleigh,2509,1773,1224,5506
2020,9,114,Charlotte,1805,2166,1138,5109
2020,9,117,Greenville,642,873,679,2194
2020,9,160,Asheville,935,1673,509,3117
2020,9,215,Columbia,2099,1070,559,3728
2020,9,216,Piedmont,970,501,1230,2701
2020,9,218,Charleston,987,1055,639,2681
2020,9,364,Macon,655,239,330,1224
2020,9,365,Savannah,1326,638,791,2755
2020,9,367,Buford,2361,1314,1493,5168
2020,9,520,Knoxville,627,377,455,1459
2020,9,536,Chattanooga,571,207,98,876
2020,10,113,Raleigh,2393,1726,1452,5571
2020,10,114,Charlotte,2275,686,1561,4522
2020,10,117,Greenville,397,641,313,1351
2020,10,160,Asheville,1085,390,882,2357
2020,10,215,Columbia,2219,1319,854,4392
2020,10,216,Piedmont,1091,921,718,2730
2020,10,218,Charleston,1316,1179,624,3119
2020,10,364,Macon,460,321,247,1028
2020,10,365,Savannah,1050,944,1030,3024
2020,10,367,Buford,1965,1303,1630,4898
2020,10,520,Knoxville,788,180,276,1244
2020,10,536,Chattanooga,746,106,152,1004
2020,11,113,Raleigh,2057,1321,1133,4511
2020,11,114,Charlotte,2103,972,2164,5239
2020,11,117,Greenville,585,433,502,1520
2020,11,160,Asheville,879,1049,425,2353
2020,11,215,Columbia,1855,1016,978,3849
2020,11,216,Piedmont,813,1354,332,2499
2020,11,218,Charleston,993,347,419,1759
2020,11,364,Macon,952,263,212,1427
2020,11,365,Savannah,1331,190,680,2201
2020,11,367,Buford,1489,1286,1010,3785
2020,11,520,Knoxville,752,459,367,1578
2020,11,536,Chattanooga,674,125,145,944
2020,12,113,Raleigh,2258,2907,1469,6634
2020,12,114,Charlotte,1952,1319,2267,5538
2020,12,117,Greenville,291,479,322,1092
2020,12,160,Asheville,1074,449,630,2153
2020,12,215,Columbia,1530,2156,1231,4917
2020,12,216,Piedmont,999,1153,738,2890
2020,12,218,Charleston,995,553,461,2009
2020,12,364,Macon,585,274,381,1240
2020,12,365,Savannah,1203,582,921,2706
2020,12,367,Buford,1702,822,934,3458
2020,12,520,Knoxville,675,260,228,1163
2020,12,536,Chattanooga,740,140,211,1091
2021,1,113,Raleigh,2835,1351,836,5022
2021,1,114,Charlotte,2174,1486,2074,5734
2021,1,117,Greenville,546,526,418,1490
2021,1,160,Asheville,1403,447,390,2240
2021,1,215,Columbia,1649,366,1065,3080
2021,1,216,Piedmont,949,707,347,2003
2021,1,218,Charleston,1095,351,515,1961
2021,1,364,Macon,918,226,110,1254
2021,1,365,Savannah,1811,580,481,2872
2021,1,367,Buford,1534,843,943,3320
2021,1,520,Knoxville,563,374,529,1466
2021,1,536,Chattanooga,509,430,88,1027
2021,2,113,Raleigh,2670,2187,1062,5919
2021,2,114,Charlotte,2378,1662,2753,6793
2021,2,117,Greenville,139,790,399,1328
2021,2,160,Asheville,1289,818,766,2873
2021,2,215,Columbia,1553,1209,1393,4155
2021,2,216,Piedmont,875,507,589,1971
2021,2,218,Charleston,771,482,547,1800
2021,2,364,Macon,977,174,157,1308
2021,2,365,Savannah,1590,311,947,2848
2021,2,367,Buford,2152,1236,890,4278
2021,2,520,Knoxville,362,134,176,672
2021,2,536,Chattanooga,390,183,86,659
2021,3,113,Raleigh,2987,1686,984,5657
2021,3,114,Charlotte,3109,2185,1965,7259
2021,3,117,Greenville,119,765,1014,1898
2021,3,160,Asheville,1264,1331,1194,3789
2021,3,215,Columbia,1792,923,3077,5792
2021,3,216,Piedmont,1462,1410,3875,6747
2021,3,218,Charleston,2349,940,1432,4721
2021,3,364,Macon,658,259,306,1223
2021,3,365,Savannah,1291,1416,1191,3898
2021,3,367,Buford,2172,1369,1504,5045
2021,3,520,Knoxville,763,302,425,1490
2021,3,536,Chattanooga,802,544,64,1410
2021,4,113,Raleigh,4132,1601,1257,6990
2021,4,114,Charlotte,3248,1223,1889,6360
2021,4,117,Greenville,20,368,378,766
2021,4,160,Asheville,1570,1160,825,3555
2021,4,215,Columbia,1015,624,1000,2639
2021,4,216,Piedmont,1119,1136,1728,3983
2021,4,218,Charleston,1652,1348,767,3767
2021,4,364,Macon,437,112,110,659
2021,4,365,Savannah,1392,723,1006,3121
2021,4,367,Buford,1490,1071,1752,4313
2021,4,520,Knoxville,716,379,198,1293
2021,4,536,Chattanooga,638,221,100,959
2021,5,113,Raleigh,5019,1207,2106,8332
2021,5,114,Charlotte,2784,2555,1691,7030
2021,5,117,Greenville,4,390,410,804
2021,5,160,Asheville,1306,1147,943,3396
2021,5,215,Columbia,1390,459,1460,3309
2021,5,216,Piedmont,1517,1687,576,3780
2021,5,218,Charleston,1392,516,714,2622
2021,5,364,Macon,474,628,250,1352
2021,5,365,Savannah,1204,776,954,2934
2021,5,367,Buford,1872,1172,1158,4202
2021,5,520,Knoxville,893,109,143,1145
2021,5,536,Chattanooga,643,351,43,1037
2021,6,113,Raleigh,3491,1238,841,5570
2021,6,114,Charlotte,3775,1933,2817,8525
2021,6,117,Greenville,121,832,409,1362
2021,6,160,Asheville,1329,548,993,2870
2021,6,215,Columbia,1345,493,312,2150
2021,6,216,Piedmont,1646,1285,795,3726
2021,6,218,Charleston,1516,740,1171,3427
2021,6,364,Macon,404,73,127,604
2021,6,365,Savannah,2911,869,890,4670
2021,6,367,Buford,2217,2091,1992,6300
2021,6,520,Knoxville,594,85,119,798
2021,6,536,Chattanooga,455,299,118,872
2021,7,113,Raleigh,4296,1074,1046,6416
2021,7,114,Charlotte,3376,1341,1842,6559
2021,7,117,Greenville,15,434,822,1271
2021,7,160,Asheville,2239,602,663,3504
2021,7,215,Columbia,1618,815,1110,3543
2021,7,216,Piedmont,1166,2234,890,4290
2021,7,218,Charleston,1363,784,882,3029
2021,7,364,Macon,378,819,241,1438
2021,7,365,Savannah,1865,968,1329,4162
2021,7,367,Buford,1787,1360,1138,4285
2021,7,520,Knoxville,785,737,140,1662
2021,7,536,Chattanooga,444,447,91,982
2021,8,113,Raleigh,3036,1184,956,5176
2021,8,114,Charlotte,2380,1829,3039,7248
2021,8,117,Greenville,20,555,984,1559
2021,8,160,Asheville,1263,570,1377,3210
2021,8,215,Columbia,1491,256,1603,3350
2021,8,216,Piedmont,1009,990,510,2509
2021,8,218,Charleston,1086,342,563,1991
2021,8,364,Macon,146,375,334,855
2021,8,365,Savannah,1706,1225,1182,4113
2021,8,367,Buford,1949,1628,1005,4582
2021,8,520,Knoxville,382,310,382,1074
2021,8,536,Chattanooga,622,511,79,1212
2021,9,113,Raleigh,4022,1581,986,6589
2021,9,114,Charlotte,2554,1498,1983,6035
2021,9,117,Greenville,129,353,739,1221
2021,9,160,Asheville,1898,590,851,3339
2021,9,215,Columbia,1472,734,783,2989
2021,9,216,Piedmont,1123,937,392,2452
2021,9,218,Charleston,1522,725,704,2951
2021,9,364,Macon,510,491,128,1129
2021,9,365,Savannah,1586,1350,1718,4654
2021,9,367,Buford,1470,1521,1083,4074
2021,9,520,Knoxville,407,219,65,691
2021,9,536,Chattanooga,526,179,134,839
2021,10,113,Raleigh,3562,1584,1035,6181
2021,10,114,Charlotte,2460,2252,2263,6975
2021,10,117,Greenville,177,1290,409,1876
2021,10,160,Asheville,1500,732,647,2879
2021,10,215,Columbia,1698,307,1278,3283
2021,10,216,Piedmont,733,891,326,1950
2021,10,218,Charleston,1629,466,970,3065
2021,10,364,Macon,168,617,409,1194
2021,10,365,Savannah,1164,1031,1351,3546
2021,10,367,Buford,2167,1124,632,3923
2021,10,520,Knoxville,613,117,243,973
2021,10,536,Chattanooga,446,237,82,765
2021,11,113,Raleigh,3233,1120,983,5336
2021,11,114,Charlotte,2816,936,1972,5724
2021,11,117,Greenville,29,1717,418,2164
2021,11,160,Asheville,1002,1693,951,3646
2021,11,215,Columbia,1505,591,830,2926
2021,11,216,Piedmont,747,1251,396,2394
2021,11,218,Charleston,1237,777,1080,3094
2021,11,364,Macon,216,212,223,651
2021,11,365,Savannah,1207,1108,933,3248
2021,11,367,Buford,1992,1275,600,3867
2021,11,520,Knoxville,567,446,165,1178
2021,11,536,Chattanooga,430,462,326,1218
2021,12,113,Raleigh,3502,1318,685,5505
2021,12,114,Charlotte,2887,1480,2749,7116
2021,12,117,Greenville,88,454,683,1225
2021,12,160,Asheville,1895,462,1521,3878
2021,12,215,Columbia,1183,1479,805,3467
2021,12,216,Piedmont,895,1083,664,2642
2021,12,218,Charleston,1546,808,406,2760
2021,12,364,Macon,1138,433,161,1732
2021,12,365,Savannah,2570,903,667,4140
2021,12,367,Buford,1539,1486,1240,4265
2021,12,520,Knoxville,830,118,78,1026
2021,12,536,Chattanooga,387,129,307,823
2022,1,113,Raleigh,2514,1018,352,3884
2022,1,114,Charlotte,2991,1370,1436,5797
2022,1,117,Greenville,188,631,570,1389
2022,1,160,Asheville,1172,788,1016,2976
2022,1,215,Columbia,1732,694,206,2632
2022,1,216,Piedmont,975,1044,518,2537
2022,1,218,Charleston,1154,204,493,1851
2022,1,364,Macon,215,502,97,814
2022,1,365,Savannah,1693,1310,2199,5202
2022,1,367,Buford,1986,1752,691,4429
2022,1,520,Knoxville,493,287,72,852
2022,1,536,Chattanooga,333,140,122,595
2022,2,113,Raleigh,2871,951,437,4259
2022,2,114,Charlotte,2122,3311,2253,7686
2022,2,117,Greenville,66,635,438,1139
2022,2,160,Asheville,1753,536,852,3141
2022,2,215,Columbia,1192,2545,500,4237
2022,2,216,Piedmont,991,1113,806,2910
2022,2,218,Charleston,2861,793,1075,4729
2022,2,364,Macon,203,542,123,868
2022,2,365,Savannah,2253,1410,843,4506
2022,2,367,Buford,2251,1743,1463,5457
2022,2,520,Knoxville,434,359,186,979
2022,2,536,Chattanooga,612,192,61,865
2022,3,113,Raleigh,3440,2455,675,6570
2022,3,114,Charlotte,2688,2164,3060,7912
2022,3,117,Greenville,21,2589,480,3090
2022,3,160,Asheville,1623,2926,835,5384
2022,3,215,Columbia,1780,743,1401,3924
2022,3,216,Piedmont,1377,1340,193,2910
2022,3,218,Charleston,1771,814,782,3367
2022,3,364,Macon,569,863,193,1625
2022,3,365,Savannah,2171,1436,1666,5273
2022,3,367,Buford,2180,1773,1304,5257
2022,3,520,Knoxville,859,313,74,1246
2022,3,536,Chattanooga,568,180,169,917
2022,4,113,Raleigh,3660,1683,704,6047
2022,4,114,Charlotte,2231,2543,2679,7453
2022,4,117,Greenville,65,856,402,1323
2022,4,160,Asheville,1455,1220,539,3214
2022,4,215,Columbia,1324,1103,336,2763
2022,4,216,Piedmont,1002,780,546,2328
2022,4,218,Charleston,1473,954,943,3370
2022,4,364,Macon,471,317,98,886
2022,4,365,Savannah,1876,1176,1059,4111
2022,4,367,Buford,1679,1520,1215,4414
2022,4,520,Knoxville,821,147,34,1002
2022,4,536,Chattanooga,410,181,170,761
2022,5,113,Raleigh,4738,1314,272,6324
2022,5,114,Charlotte,1788,1919,2538,6245
2022,5,117,Greenville,-7,771,509,1273
2022,5,160,Asheville,1508,347,708,2563
2022,5,215,Columbia,1423,621,502,2546
2022,5,216,Piedmont,1029,1024,524,2577
2022,5,218,Charleston,1922,361,1177,3460
2022,5,364,Macon,1183,479,130,1792
2022,5,365,Savannah,1443,851,960,3254
2022,5,367,Buford,1605,2254,708,4567
2022,5,520,Knoxville,768,237,40,1045
2022,5,536,Chattanooga,571,132,237,940
2022,6,113,Raleigh,3882,1009,746,5637
2022,6,114,Charlotte,3251,3144,2222,8617
2022,6,117,Greenville,32,1534,867,2433
2022,6,160,Asheville,1399,1649,853,3901
2022,6,215,Columbia,1983,617,231,2831
2022,6,216,Piedmont,1467,883,249,2599
2022,6,218,Charleston,2011,759,661,3431
2022,6,364,Macon,669,858,102,1629
2022,6,365,Savannah,1610,1245,886,3741
2022,6,367,Buford,2119,1923,663,4705
2022,6,520,Knoxville,732,326,117,1175
2022,6,536,Chattanooga,815,246,91,1152
2022,7,113,Raleigh,3178,2152,504,5834
2022,7,114,Charlotte,2755,1950,1399,6104
2022,7,117,Greenville,51,2260,877,3188
2022,7,160,Asheville,1686,564,1152,3402
2022,7,215,Columbia,2709,605,1176,4490
2022,7,216,Piedmont,888,733,-289,1332
2022,7,218,Charleston,1500,1010,398,2908
2022,7,364,Macon,538,394,96,1028
2022,7,365,Savannah,1286,1506,1423,4215
2022,7,367,Buford,1471,1895,823,4189
2022,7,520,Knoxville,655,248,82,985
2022,7,536,Chattanooga,527,379,76,982
2022,8,113,Raleigh,3005,1262,843,5110
2022,8,114,Charlotte,2995,2499,2184,7678
2022,8,117,Greenville,95,561,1379,2035
2022,8,160,Asheville,1307,1279,876,3462
2022,8,215,Columbia,1650,729,543,2922
2022,8,216,Piedmont,1088,955,290,2333
2022,8,218,Charleston,1362,746,744,2852
2022,8,364,Macon,701,455,110,1266
2022,8,365,Savannah,1855,1749,1803,5407
2022,8,367,Buford,1676,1042,567,3285
2022,8,520,Knoxville,451,237,98,786
2022,8,536,Chattanooga,726,248,89,1063
2022,9,113,Raleigh,3247,726,637,4610
2022,9,114,Charlotte,2343,1981,1669,5993
2022,9,117,Greenville,85,1173,2051,3309
2022,9,160,Asheville,1535,943,819,3297
2022,9,215,Columbia,1105,610,698,2413
2022,9,216,Piedmont,1026,843,308,2177
2022,9,218,Charleston,2206,555,210,2971
2022,9,364,Macon,646,392,225,1263
2022,9,365,Savannah,1560,1559,819,3938
2022,9,367,Buford,1997,948,724,3669
2022,9,520,Knoxville,514,341,75,930
2022,9,536,Chattanooga,616,160,32,808
2022,10,113,Raleigh,3490,1574,743,5807
2022,10,114,Charlotte,2542,3462,1739,7743
2022,10,117,Greenville,66,1693,2264,4023
2022,10,160,Asheville,1312,662,504,2478
2022,10,215,Columbia,1251,455,452,2158
2022,10,216,Piedmont,1456,828,402,2686
2022,10,218,Charleston,1118,701,499,2318
2022,10,364,Macon,625,347,127,1099
2022,10,365,Savannah,2596,882,793,4271
2022,10,367,Buford,1658,2185,998,4841
2022,10,520,Knoxville,423,159,180,762
2022,10,536,Chattanooga,363,332,263,958
2022,11,113,Raleigh,2149,1286,770,4205
2022,11,114,Charlotte,1972,2278,1894,6144
2022,11,117,Greenville,68,1028,1935,3031
2022,11,160,Asheville,914,1507,393,2814
2022,11,215,Columbia,1590,821,445,2856
2022,11,216,Piedmont,1249,556,298,2103
2022,11,218,Charleston,1644,703,492,2839
2022,11,364,Macon,479,456,89,1024
2022,11,365,Savannah,1541,1848,514,3903
2022,11,367,Buford,1658,1544,461,3663
2022,11,520,Knoxville,637,328,35,1000
2022,11,536,Chattanooga,543,274,203,1020
2022,12,113,Raleigh,2213,1458,438,4109
2022,12,114,Charlotte,1763,2198,2504,6465
2022,12,117,Greenville,43,1763,2168,3974
2022,12,160,Asheville,1763,1708,859,4330
2022,12,215,Columbia,1012,1514,531,3057
2022,12,216,Piedmont,515,1186,494,2195
2022,12,218,Charleston,1449,609,1197,3255
2022,12,364,Macon,594,210,185,989
2022,12,365,Savannah,1067,1142,969,3178
2022,12,367,Buford,1651,2062,884,4597
2022,12,520,Knoxville,347,46,26,419
2022,12,536,Chattanooga,540,450,36,1026
2023,1,113,Raleigh,3574,835,361,4770
2023,1,114,Charlotte,2135,1635,1825,5595
2023,1,117,Greenville,185,1135,1711,3031
2023,1,160,Asheville,1341,408,407,2156
2023,1,215,Columbia,1174,208,556,1938
2023,1,216,Piedmont,779,968,307,2054
2023,1,218,Charleston,1636,574,370,2580
2023,1,364,Macon,948,332,126,1406
2023,1,365,Savannah,1348,2043,568,3959
2023,1,367,Buford,1499,1309,615,3423
2023,1,520,Knoxville,425,229,26,680
2023,1,536,Chattanooga,512,216,64,792
2023,2,113,Raleigh,3145,1024,621,4790
2023,2,114,Charlotte,3265,2293,1991,7549
2023,2,117,Greenville,39,1089,2282,3410
2023,2,160,Asheville,1254,467,397,2118
2023,2,215,Columbia,1349,738,427,2514
2023,2,216,Piedmont,1213,1411,269,2893
2023,2,218,Charleston,2064,613,275,2952
2023,2,364,Macon,390,747,102,1239
2023,2,365,Savannah,1022,1313,749,3084
2023,2,367,Buford,1797,1242,790,3829
2023,2,520,Knoxville,735,180,11,926
2023,2,536,Chattanooga,562,453,204,1219
2023,3,113,Raleigh,3642,2045,741,6428
2023,3,114,Charlotte,3300,2388,2847,8535
2023,3,117,Greenville,35,1126,1828,2989
2023,3,160,Asheville,1653,546,852,3051
2023,3,215,Columbia,1611,660,807,3078
2023,3,216,Piedmont,1481,1209,552,3242
2023,3,218,Charleston,1580,1072,588,3240
2023,3,364,Macon,745,449,186,1380
2023,3,365,Savannah,1387,1501,1692,4580
2023,3,367,Buford,2126,926,1053,4105
2023,3,520,Knoxville,625,387,5,1017
2023,3,536,Chattanooga,564,287,60,911
2023,4,113,Raleigh,2555,1398,390,4343
2023,4,114,Charlotte,2333,1637,2226,6196
2023,4,117,Greenville,149,844,1557,2550
2023,4,160,Asheville,1474,465,533,2472
2023,4,215,Columbia,924,661,1252,2837
2023,4,216,Piedmont,1237,586,932,2755
2023,4,218,Charleston,1388,1245,1026,3659
2023,4,364,Macon,961,191,64,1216
2023,4,365,Savannah,1015,993,2433,4441
2023,4,367,Buford,1775,1207,614,3596
2023,4,520,Knoxville,493,192,108,793
2023,4,536,Chattanooga,525,155,20,700
2023,5,113,Raleigh,3493,1355,455,5303
2023,5,114,Charlotte,3250,1601,3029,7880
2023,5,117,Greenville,73,1732,2273,4078
2023,5,160,Asheville,1437,671,499,2607
2023,5,215,Columbia,1234,286,656,2176
2023,5,216,Piedmont,2176,983,1326,4485
2023,5,218,Charleston,1780,769,785,3334
2023,5,364,Macon,951,511,103,1565
2023,5,365,Savannah,1283,184,1332,2799
2023,5,367,Buford,2240,1224,725,4189
2023,5,520,Knoxville,426,255,82,763
2023,5,536,Chattanooga,391,192,79,662
2023,6,113,Raleigh,2297,1498,774,4569
2023,6,114,Charlotte,3118,1625,4020,8763
2023,6,117,Greenville,93,2192,2255,4540
2023,6,160,Asheville,1968,1608,1022,4598
2023,6,215,Columbia,1275,758,1842,3875
2023,6,216,Piedmont,967,1096,912,2975
2023,6,218,Charleston,1657,806,877,3340
2023,6,364,Macon,1047,218,210,1475
2023,6,365,Savannah,573,432,732,1737
2023,6,367,Buford,1765,1128,895,3788
2023,6,520,Knoxville,788,166,167,1121
2023,6,536,Chattanooga,496,730,294,1520
2023,7,113,Raleigh,2564,1250,310,4124
2023,7,114,Charlotte,2766,2313,2738,7817
2023,7,117,Greenville,58,1283,1933,3274
2023,7,160,Asheville,799,664,572,2035
2023,7,215,Columbia,1641,668,841,3150
2023,7,216,Piedmont,1381,1143,1125,3649
2023,7,218,Charleston,1550,1261,534,3345
2023,7,364,Macon,782,620,67,1469
2023,7,365,Savannah,1178,575,1222,2975
2023,7,367,Buford,1611,1242,1187,4040
2023,7,520,Knoxville,583,312,100,995
2023,7,536,Chattanooga,288,210,100,598
2023,8,113,Raleigh,4083,1277,1045,6405
2023,8,114,Charlotte,2619,1961,3032,7612
2023,8,117,Greenville,71,1675,1914,3660
2023,8,160,Asheville,1985,3050,560,5595
2023,8,215,Columbia,1483,1014,1118,3615
2023,8,216,Piedmont,1372,1045,829,3246
2023,8,218,Charleston,2277,534,697,3508
2023,8,364,Macon,995,306,280,1581
2023,8,365,Savannah,1150,1185,1928,4263
2023,8,367,Buford,2757,1216,1078,5051
2023,8,520,Knoxville,516,242,70,828
2023,8,536,Chattanooga,981,152,46,1179
2023,9,113,Raleigh,2661,1283,644,4588
2023,9,114,Charlotte,2273,3081,2481,7835
2023,9,117,Greenville,62,1186,3182,4430
2023,9,160,Asheville,1804,485,700,2989
2023,9,215,Columbia,1640,764,997,3401
2023,9,216,Piedmont,1256,792,1678,3726
2023,9,218,Charleston,1732,642,1216,3590
2023,9,364,Macon,602,732,144,1478
2023,9,365,Savannah,869,855,1793,3517
2023,9,367,Buford,1452,1712,1059,4223
2023,9,520,Knoxville,338,303,186,827
2023,9,536,Chattanooga,647,174,414,1235
2023,10,113,Raleigh,3515,1916,432,5863
2023,10,114,Charlotte,2595,2447,3630,8672
2023,10,117,Greenville,97,1838,1900,3835
2023,10,160,Asheville,1647,1398,937,3982
2023,10,215,Columbia,1801,861,1192,3854
2023,10,216,Piedmont,1274,1530,256,3060
2023,10,218,Charleston,1359,729,809,2897
2023,10,364,Macon,901,621,257,1779
2023,10,365,Savannah,902,708,1220,2830
2023,10,367,Buford,2328,2125,938,5391
2023,10,520,Knoxville,364,301,138,803
2023,10,536,Chattanooga,719,299,233,1251
2023,11,113,Raleigh,2271,1143,784,4198
2023,11,114,Charlotte,2251,1654,3431,7336
2023,11,117,Greenville,103,1528,2155,3786
2023,11,160,Asheville,1339,483,1171,2993
2023,11,215,Columbia,1240,439,747,2426
2023,11,216,Piedmont,1030,838,1066,2934
2023,11,218,Charleston,1726,564,1106,3396
2023,11,364,Macon,1186,230,450,1866
2023,11,365,Savannah,1114,999,970,3083
2023,11,367,Buford,1429,1146,1250,3825
2023,11,520,Knoxville,421,414,128,963
2023,11,536,Chattanooga,1019,119,48,1186
2023,12,113,Raleigh,2132,1188,513,3833
2023,12,114,Charlotte,2085,1448,3069,6602
2023,12,117,Greenville,27,1516,1979,3522
2023,12,160,Asheville,874,844,819,2537
2023,12,215,Columbia,1584,984,1291,3859
2023,12,216,Piedmont,922,589,642,2153
2023,12,218,Charleston,1341,330,1111,2782
2023,12,364,Macon,752,626,316,1694
2023,12,365,Savannah,1377,1572,1296,4245
2023,12,367,Buford,1279,1023,602,2904
2023,12,520,Knoxville,528,372,184,1084
2023,12,536,Chattanooga,963,239,137,1339
2024,1,113,Raleigh,3310,761,1013,5084
2024,1,114,Charlotte,2427,1640,4369,8436
2024,1,117,Greenville,87,767,2138,2992
2024,1,160,Asheville,1261,427,624,2312
2024,1,215,Columbia,1698,465,1673,3836
2024,1,216,Piedmont,1334,760,468,2562
2024,1,218,Charleston,1749,913,730,3392
2024,1,364,Macon,1010,314,409,1733
2024,1,365,Savannah,1388,497,1646,3531
2024,1,367,Buford,1518,1132,767,3417
2024,1,520,Knoxville,485,352,150,987
2024,1,536,Chattanooga,570,119,72,761
2024,2,113,Raleigh,2469,1081,758,4308
2024,2,114,Charlotte,3049,1803,4105,8957
2024,2,117,Greenville,169,934,2552,3655
2024,2,160,Asheville,1621,1550,484,3655
2024,2,215,Columbia,1206,1274,1220,3700
2024,2,216,Piedmont,1239,689,782,2710
2024,2,218,Charleston,1346,592,642,2580
2024,2,364,Macon,1025,278,334,1637
2024,2,365,Savannah,1361,712,1220,3293
2024,2,367,Buford,1650,1336,813,3799
2024,2,520,Knoxville,843,214,199,1256
2024,2,536,Chattanooga,418,380,3,801
2024,3,113,Raleigh,2734,1240,554,4528
2024,3,114,Charlotte,3391,2040,2956,8387
2024,3,117,Greenville,60,1011,1998,3069
2024,3,160,Asheville,1856,942,368,3166
2024,3,215,Columbia,1211,917,1953,4081
2024,3,216,Piedmont,1227,841,660,2728
2024,3,218,Charleston,1954,1027,521,3502
2024,3,364,Macon,666,520,116,1302
2024,3,365,Savannah,802,1181,1950,3933
2024,3,367,Buford,1813,1101,924,3838
2024,3,520,Knoxville,642,199,103,944
2024,3,536,Chattanooga,556,175,82,813
2024,4,113,Raleigh,3893,1072,849,5814
2024,4,114,Charlotte,2677,1739,2516,6932
2024,4,117,Greenville,99,1293,2535,3927
2024,4,160,Asheville,1816,814,542,3172
2024,4,215,Columbia,1284,434,1529,3247
2024,4,216,Piedmont,1550,825,2484,4859
2024,4,218,Charleston,1768,766,1002,3536
2024,4,364,Macon,1153,463,223,1839
2024,4,365,Savannah,1234,765,897,2896
2024,4,367,Buford,1285,1498,389,3172
2024,4,520,Knoxville,826,243,578,1647
2024,4,536,Chattanooga,479,29,107,615
2024,5,113,Raleigh,3554,1350,1576,6480
2024,5,114,Charlotte,2843,2058,3014,7915
2024,5,117,Greenville,178,607,1909,2694
2024,5,160,Asheville,1534,1021,524,3079
2024,5,215,Columbia,1458,657,1370,3485
2024,5,216,Piedmont,1529,839,1095,3463
2024,5,218,Charleston,1901,426,1519,3846
2024,5,364,Macon,1267,441,417,2125
2024,5,365,Savannah,1956,583,1160,3699
2024,5,367,Buford,1658,1625,1256,4539
2024,5,520,Knoxville,638,274,160,1072
2024,5,536,Chattanooga,726,77,148,951
2024,6,113,Raleigh,3379,1319,926,5624
2024,6,114,Charlotte,3242,1694,1893,6829
2024,6,117,Greenville,12,1196,1755,2963
2024,6,160,Asheville,1619,766,491,2876
2024,6,215,Columbia,1153,913,1822,3888
2024,6,216,Piedmont,1275,668,1005,2948
2024,6,218,Charleston,1488,728,1421,3637
2024,6,364,Macon,1180,362,85,1627
2024,6,365,Savannah,840,591,970,2401
2024,6,367,Buford,1575,1084,1404,4063
2024,6,520,Knoxville,586,373,195,1154
2024,6,536,Chattanooga,546,227,181,954
2024,7,113,Raleigh,2964,933,475,4372
2024,7,114,Charlotte,2522,1763,2852,7137
2024,7,117,Greenville,191,1343,2042,3576
2024,7,160,Asheville,1345,737,699,2781
2024,7,215,Columbia,1169,1045,1860,4074
2024,7,216,Piedmont,2116,927,476,3519
2024,7,218,Charleston,1423,793,865,3081
2024,7,364,Macon,850,542,347,1739
2024,7,365,Savannah,1957,558,970,3485
2024,7,367,Buford,1697,1575,1824,5096
2024,7,520,Knoxville,763,512,50,1325
2024,7,536,Chattanooga,666,130,219,1015
2024,8,113,Raleigh,3662,1577,1383,6622
2024,8,114,Charlotte,2673,1898,2649,7220
2024,8,117,Greenville,42,1278,1866,3186
2024,8,160,Asheville,1714,1141,303,3158
2024,8,215,Columbia,1354,1388,1485,4227
2024,8,216,Piedmont,1691,1046,1575,4312
2024,8,218,Charleston,1560,567,573,2700
2024,8,364,Macon,937,514,163,1614
2024,8,365,Savannah,1182,1767,2452,5401
2024,8,367,Buford,1485,2523,1032,5040
2024,8,520,Knoxville,784,375,155,1314
2024,8,536,Chattanooga,708,248,318,1274
2024,9,113,Raleigh,2770,454,681,3905
2024,9,114,Charlotte,2245,2668,2742,7655
2024,9,117,Greenville,71,2164,1939,4174
2024,9,160,Asheville,1548,660,452,2660
2024,9,215,Columbia,1173,665,1313,3151
2024,9,216,Piedmont,1152,992,999,3143
2024,9,218,Charleston,1677,571,505,2753
2024,9,364,Macon,704,154,48,906
2024,9,365,Savannah,680,723,1077,2480
2024,9,367,Buford,1837,1347,299,3483
2024,9,520,Knoxville,921,59,91,1071
2024,9,536,Chattanooga,570,136,7,713
2024,10,113,Raleigh,2177,1454,1435,5066
2024,10,114,Charlotte,2472,2937,3858,9267
2024,10,117,Greenville,121,902,2778,3801
2024,10,160,Asheville,1532,887,714,3133
2024,10,215,Columbia,997,968,1843,3808
2024,10,216,Piedmont,1732,1540,919,4191
2024,10,218,Charleston,1783,695,888,3366
2024,10,364,Macon,1115,210,178,1503
2024,10,365,Savannah,1155,1016,925,3096
2024,10,367,Buford,1444,645,692,2781
2024,10,520,Knoxville,903,329,162,1394
2024,10,536,Chattanooga,657,661,476,1794
2024,11,113,Raleigh,3978,991,1203,6172
2024,11,114,Charlotte,2762,1371,3986,8119
2024,11,117,Greenville,40,337,1478,1855
2024,11,160,Asheville,2039,759,310,3108
2024,11,215,Columbia,1020,1126,913,3059
2024,11,216,Piedmont,1003,890,1581,3474
2024,11,218,Charleston,2108,597,333,3038
2024,11,364,Macon,587,575,365,1527
2024,11,365,Savannah,674,569,927,2170
2024,11,367,Buford,1316,940,636,2892
2024,11,520,Knoxville,468,181,276,925
2024,11,536,Chattanooga,529,413,223,1165
2024,12,113,Raleigh,2046,1003,584,3633
2024,12,114,Charlotte,2304,1949,4542,8795
2024,12,117,Greenville,59,2315,1513,3887
2024,12,160,Asheville,1911,718,681,3310
2024,12,215,Columbia,1093,567,1495,3155
2024,12,216,Piedmont,1044,1135,900,3079
2024,12,218,Charleston,907,990,772,2669
2024,12,364,Macon,398,381,156,935
2024,12,365,Savannah,800,978,1649,3427
2024,12,367,Buford,1257,1008,2384,4649
2024,12,520,Knoxville,446,307,272,1025
2024,12,536,Chattanooga,422,368,20,810
2025,1,113,Raleigh,1905,835,1241,3981
2025,1,114,Charlotte,1970,1596,2445,6011
2025,1,117,Greenville,61,730,1481,2272
2025,1,160,Asheville,1193,864,782,2839
2025,1,215,Columbia,1132,859,1178,3169
2025,1,216,Piedmont,1472,558,643,2673
2025,1,218,Charleston,1400,410,582,2392
2025,1,364,Macon,747,295,181,1223
2025,1,365,Savannah,1604,564,1231,3399
2025,1,367,Buford,1258,1102,1027,3387
2025,1,520,Knoxville,443,232,317,992
2025,1,536,Chattanooga,574,135,178,887
2025,2,113,Raleigh,2380,1328,789,4497
2025,2,114,Charlotte,2583,2043,2114,6740
2025,2,117,Greenville,26,708,1632,2366
2025,2,160,Asheville,1886,1103,979,3968
2025,2,215,Columbia,1302,620,1362,3284
2025,2,216,Piedmont,1720,1035,643,3398
2025,2,218,Charleston,1514,119,561,2194
2025,2,364,Macon,510,186,79,775
2025,2,365,Savannah,1326,1035,1382,3743
2025,2,367,Buford,1435,1441,1179,4055
2025,2,520,Knoxville,644,316,242,1202
2025,2,536,Chattanooga,474,243,22,739
2025,3,113,Raleigh,2705,1009,1565,5279
2025,3,114,Charlotte,4172,1881,3636,9689
2025,3,117,Greenville,193,1102,2322,3617
2025,3,160,Asheville,1907,1018,923,3848
2025,3,215,Columbia,1050,932,2472,4454
2025,3,216,Piedmont,1432,1442,2247,5121
2025,3,218,Charleston,1461,856,962,3279
2025,3,364,Macon,665,392,189,1246
2025,3,365,Savannah,1079,650,603,2332
2025,3,367,Buford,1673,1644,891,4208
2025,3,520,Knoxville,751,162,367,1280
2025,3,536,Chattanooga,587,213,145,945
2025,4,113,Raleigh,3033,1270,1182,5485
2025,4,114,Charlotte,3025,2000,3429,8454
2025,4,117,Greenville,6,1043,1915,2964
2025,4,160,Asheville,1818,1221,763,3802
2025,4,215,Columbia,1367,1069,1643,4079
2025,4,216,Piedmont,1029,1578,1389,3996
2025,4,218,Charleston,1982,847,664,3493
2025,4,364,Macon,1434,484,130,2048
2025,4,365,Savannah,1083,1040,936,3059
2025,4,367,Buford,1959,1689,748,4396
2025,4,520,Knoxville,1139,351,176,1666
2025,4,536,Chattanooga,808,90,157,1055
2025,5,113,Raleigh,2338,1480,1167,4985
2025,5,114,Charlotte,2658,1350,4946,8954
2025,5,117,Greenville,16,1177,2642,3835
2025,5,160,Asheville,1539,1543,690,3772
2025,5,215,Columbia,2830,947,2577,6354
2025,5,216,Piedmont,1093,1032,825,2950
2025,5,218,Charleston,1915,543,1058,3516
2025,5,364,Macon,652,131,181,964
2025,5,365,Savannah,1132,884,940,2956
2025,5,367,Buford,1795,905,346,3046
2025,5,520,Knoxville,522,299,285,1106
2025,5,536,Chattanooga,632,184,194,1010
2025,6,113,Raleigh,2592,1630,1115,5337
2025,6,114,Charlotte,2545,2246,3880,8671
2025,6,117,Greenville,21,905,2306,3232
2025,6,160,Asheville,1895,849,714,3458
2025,6,215,Columbia,1986,988,2095,5069
2025,6,216,Piedmont,2152,1065,1192,4409
2025,6,218,Charleston,1853,600,499,2952
2025,6,364,Macon,220,130,271,621
2025,6,365,Savannah,1531,755,1501,3787
2025,6,367,Buford,1675,1722,682,4079
2025,6,520,Knoxville,690,293,135,1118
2025,6,536,Chattanooga,850,105,140,1095
2025,7,113,Raleigh,2968,1469,1750,6187
2025,7,114,Charlotte,2981,2490,2387,7858
2025,7,117,Greenville,120,979,3121,4220
2025,7,160,Asheville,1430,1465,537,3432
2025,7,215,Columbia,1291,873,2278,4442
2025,7,216,Piedmont,1406,1763,882,4051
2025,7,218,Charleston,1961,802,602,3365
2025,7,364,Macon,680,359,239,1278
2025,7,365,Savannah,1194,635,911,2740
2025,7,367,Buford,1498,1194,1290,3982
2025,7,520,Knoxville,376,421,436,1233
2025,7,536,Chattanooga,651,192,119,962
2025,8,113,Raleigh,2705,1060,755,4520
2025,8,114,Charlotte,3341,2161,3361,8863
2025,8,117,Greenville,40,827,3099,3966
2025,8,160,Asheville,1742,843,564,3149
2025,8,215,Columbia,1094,568,1121,2783
2025,8,216,Piedmont,1684,2351,857,4892
2025,8,218,Charleston,1339,1209,353,2901
2025,8,364,Macon,663,491,149,1303
2025,8,365,Savannah,1354,746,1712,3812
2025,8,367,Buford,1412,1355,1512,4279
2025,8,520,Knoxville,595,571,231,1397
2025,8,536,Chattanooga,988,283,65,1336
2025,9,113,Raleigh,2542,893,1722,5157
2025,9,114,Charlotte,2773,1962,2646,7381
2025,9,117,Greenville,120,682,3132,3934
2025,9,160,Asheville,1989,744,323,3056
2025,9,215,Columbia,1122,1237,1306,3665
2025,9,216,Piedmont,1645,961,2032,4638
2025,9,218,Charleston,1376,644,590,2610
2025,9,364,Macon,709,628,85,1422
2025,9,365,Savannah,1094,651,926,2671
2025,9,367,Buford,1752,1266,2488,5506
2025,9,520,Knoxville,830,143,602,1575
2025,9,536,Chattanooga,1311,259,242,1812
